{
  "__name": "expedition_data_by_map",
  "all": [
    1,
    2,
    3,
    4,
    5,
    6,
    7,
    8,
    9,
    10,
    11,
    12,
    13,
    14,
    201,
    202,
    203,
    204,
    205,
    206,
    207,
    208,
    209,
    210,
    211,
    212,
    10000,
    70000,
    1040000,
    1040001,
    1040010,
    1040011,
    1050000,
    1050010,
    1060000,
    1060001,
    1060010,
    1060011,
    1070200,
    1080000,
    1080010,
    1090000,
    1090001,
    1090010,
    1090011,
    1090012,
    1100000,
    1100001,
    1100010,
    1100011,
    1100013,
    1110001,
    1110002,
    1110011,
    1110012,
    1110021,
    1120001,
    1120002,
    1120011,
    1120012,
    1120021,
    1130000,
    1130100,
    1140001,
    1140002,
    1140011,
    1140012,
    1140021,
    1150001,
    1150002,
    1150011,
    1150012,
    1150021,
    1160001,
    1160011,
    1170001,
    1180001,
    1180002,
    1180011,
    1180012,
    1180021,
    1190000,
    1190001,
    1190010,
    1190011,
    1190021,
    1200100,
    1210001,
    1210002,
    1210011,
    1210012,
    1210021,
    1220001,
    1220021,
    1230001,
    1230002,
    1230011,
    1230012,
    1230020,
    1230021,
    1240001,
    1240002,
    1240011,
    1240012,
    1240020,
    1240021,
    1250001,
    1250002,
    1250011,
    1250012,
    1250025,
    1250026,
    1250022,
    1260001,
    1260002,
    1260011,
    1260012,
    1260025,
    1260026,
    1270001,
    1280001,
    1280025,
    1280026,
    1290001,
    1290002,
    1290025,
    1290026,
    1300001,
    1300002,
    1300011,
    1300012,
    1300025,
    1300026,
    1310001,
    1310002,
    1310011,
    1310012,
    1310025,
    1310026,
    1320001,
    1330001,
    1330002,
    1330011,
    1330012,
    1330025,
    1330026,
    1340001,
    1340002,
    1340011,
    1340012,
    1340021,
    1350001,
    1360001,
    1360002,
    1360011,
    1360012,
    1360025,
    1360026,
    1370001,
    1380001,
    1380002,
    1380011,
    1380012,
    1380025,
    1380026,
    1390001,
    1400001,
    1400002,
    1400011,
    1400012,
    1400020,
    1400021,
    1410001,
    1410002,
    1410011,
    1410012,
    1410020,
    1410021,
    1420001,
    1430001,
    1430002,
    1430003,
    1440001,
    1450001,
    1450002,
    1450003,
    1460001,
    1460002,
    1460011,
    1460012,
    1460025,
    1460026,
    1470001,
    1470002,
    1470011,
    1470012,
    1470025,
    1470026,
    1480001,
    1480002,
    1480011,
    1480012,
    1480025,
    1480026,
    1490001,
    1490002,
    1490011,
    1490012,
    1490025,
    1490026,
    1500001,
    1500002,
    1500011,
    1500012,
    1500025,
    1500026,
    1510001,
    1520001,
    1520002,
    1520011,
    1520012,
    1520025,
    1520026,
    1530001,
    1530002,
    1530011,
    1530012,
    1530025,
    1530026,
    1540001,
    1540002,
    1540003,
    1550001,
    1550002,
    1550011,
    1550012,
    1550025,
    1550026,
    1560001,
    1560002,
    1560011,
    1560012,
    1560025,
    1560026,
    1570001,
    1570002,
    1570011,
    1570012,
    1570025,
    1570026,
    1580001,
    1590001,
    1590002,
    1590003,
    1600001,
    1600002,
    1600011,
    1600012,
    1600025,
    1600026,
    1610001,
    1610002,
    1610011,
    1610012,
    1610025,
    1610026,
    1620001,
    1620002,
    1620011,
    1620012,
    1620025,
    1620026,
    1630001,
    1630002,
    1630003,
    1640001,
    1640002,
    1640011,
    1640012,
    1640025,
    1640026,
    1650001,
    1650002,
    1650011,
    1650012,
    1650025,
    1650026,
    1660001,
    1660002,
    1660011,
    1660012,
    1660025,
    1660026,
    1670001,
    1670002,
    1670003,
    1680001,
    1680002,
    1680011,
    1680012,
    1680025,
    1680026,
    1690001,
    1690002,
    1690003,
    1690004,
    1700001,
    1700002,
    1700011,
    1700012,
    1700025,
    1700026,
    1710001,
    1710002,
    1710011,
    1710012,
    1710025,
    1710026,
    2100000,
    2100001,
    2100010,
    2100011,
    2100020,
    2100021,
    2100030,
    2100031,
    2100040,
    2100041,
    2100050,
    2100051,
    2100060,
    2100061,
    2100070,
    2100071,
    2100080,
    2100081,
    2100090,
    2100091,
    2100100,
    2100101,
    2100110,
    2100111,
    2100120,
    2100121,
    2100130,
    2100131,
    2100140,
    2100141,
    2100150,
    2100151,
    2100160,
    2100161,
    2100170,
    2100171,
    2100180,
    2100181,
    2100190,
    2100191,
    2100200,
    2100201,
    2100210,
    2100211,
    2100221,
    2100222,
    2100231,
    2100232,
    2100241,
    2100242,
    2100251,
    2100252,
    2100261,
    2100262,
    2100271,
    2100272,
    2200000,
    2200010,
    2200020,
    2200030,
    2200040,
    2200050,
    2200060,
    2200070,
    2200080,
    2200090,
    9920001,
    9920002,
    9920011,
    9920012,
    9920021
  ]
}